--------------------
***--------------***
--------------------
-----**********-----
--------------------
--------------------
*******------*******
--------------------
--------------------
-----**********-----
--------------------
--------------------
*******------*******
--------------------
--------------------
